################
#.....#####....#
#..............#
#..............#
#.....###......#
#.......#####..#
#....####......#
#..............#
################