################
#.....#........#
#..####...###..#
#.....#........#
#.....#........#
#..######......#
#......#.......#
#..............#
################