#########################################################
#.....#####.............................................#
#....................................####...............#
#....................................##.................#
#.....###.....................########..................#
#.......#####...........................................#
#....####...............................................#
#.......................................................#
######################################################..#