######################################@@@@@
#..............#.....................#@@@@@
#..####.#####..#.....................#@@@@@
#.....#........#.....................#@@@@@
#.....#........#.....................#@@@@@
#..####........#.....................#@@@@@
#......#.......#.....................#@@@@@
#..............#.....................#@@@@@
#..............#.....................#@@@@@
#..............#.....................#@@@@@
#..............#.....................#@@@@@
#..............#.....................#@@@@@
#....................................#@@@@@
#....................................#@@@@@
################.....................#@@@@@
@@@@@@@@@@@@@@@#.....................#@@@@@
@@@@@@@@@@@@@@@#.....................#@@@@@
@@@@@@@@@@@@@@@#.....................#@@@@@
@@@@@@@@@@@@@@@#.....................######
@@@@@@@@@@@@@@@#...........................
@@@@@@@@@@@@@@@#...........................
@@@@@@@@@@@@@@@#.....................######
@@@@@@@@@@@@@@@#######################@@@@@
@@@@@@@@@@@@@@@@@@@@@@@@@@@@@@@@@@@@@@@@@@@