###########################################
#..............#..........................#
#..##########..#..........................#
#.....#........#..........................#
#.....#........#..........................#
#..####........#........#############.....#
#..............#........#.................#
#..............#........#.................#
#..............#........#.................#
#..............#........#.................#
#..............#........#.................#
#..............##########.................#
#.........................................#
#.........................................#
################..........................#
...............#..........................#
...............#..........................#
#..............#..........................#
#..............#.....................######
#..............#..........................#
#..............#..........................#
#..............#..........................#
#..............######################..####
#..............#..........................#
#.........................................#
#.........................................#
###########################################