#############################################################
#.....#........#....................#........#.....#........#
#..##########..#..####...###.....##########.....##########..#
#..............#..............#...................#.........#
#.......#......#.......#......#.......#...........#.........#
#.......#..............####...........#...........##........#
#.....###...........................###......#.....###......#
#..............#####..........#............###..............?
#............................?#..............#..............?
#..............###............#..............#..............#
#..............#............................................#
#..............#..............#.............................#
#############################################################